# # # # # # # # # # # # # # # # /
# . . . . # . . . . # . . . . # /
# . # # . # . . . . # . . . . # /
# . # # . # . . . . # . . . . # /
# . . # . # . . # # # # . . . # / 
. . . # . # # . # # . # . . . # /
# . . # . . . . # # . . . . . # /
# . # # # . # . . # . # . . . # /
# . # # # . # # . # . # . . . # /
# . . . . . # # . . . # . . . # / 
# # # # # # # # # # # # # # # # /

