. . . # . . . # . . . # . . . # /
. . . # . . . # . . . # . . . # /
# . # # # . # # # . # # # . # # /
. . . . . . . . . . . . . . . # /
. # . # # # . # # # . # # # . # /
. # . . # . . . # . . . # . . # /
. # . . # . . . # . . . # . . # /
. # # # # # # # # # # # # # # # /
. # # # # # # # # # # # # # # # /
. # . . . . . . . . . . . . . # /
. # . . . . . . . . . # . . . # /
. # . . . . . . . . . # . . . # /
. # . . . . . . . . . # . . . # /
. . . . . . . . . . . # # # # # /
. # . # # # # # # # . # . . . # /
. # . . . . . . . . . . . . . # /
. # # # # # # # # # # # # # # # /