# # # # . # # # # /
# # # . . . # # # /
# . . . . . . . # /
# . . . . . . # # /
# . . . . . . # # /
# . . . . . . . # /
# # . . . . . # # / 
# # # ~ | ~ # # # /
# # ~ ~ | ~ ~ # # /
# # ~ ~ | ~ ~ ~ # /
# ~ ~ ~ | ~ ~ ~ # /
# # # ~ | ~ ~ ~ # /
# # # ~ | ~ # # # /
# # # # . # # # # /
# # # . . . # # # /
# # # . . . # # # /
# # # # # # # # # /