# # # # # # # # # # # # # # # # # # # # # # # /
# . . . # # # # . . . . . . . # # # # . . . # /
# . . . . . . . . . . . . . . . . . . . . . # /
# . . . # # # # . . . . . . . # # # # . . . # /
# # # # # # # # . . . . . . . # # # # # # # # /
# . . . . . . # . . . . . . . # . . . . . . # /
# . . . . . . # . . . . . . . # . . . . . . # /
# . . . . . . # . . . . . . . # . . . . . . # /
# . . . . . . # . . . . . . . # . . . . . . # /
# . . . . . . # . . . . . . . . . . . . . . # /
# . . . . . . # . . . . . . . # . . . . . . # /
# # # . # # # # . . . . . . . # # # # . # # # /
# . . . . . . # . . . . . . . # . . . . . . # /
# # # . # # . # # # # . # # # # . # # . # # # /
# . . . . # . # ~ ~ # . # ~ ~ # . # . . . . # /
# . . . . # . . . . . . . . . . . # . . . . # /
# . . . . # # # ~ ~ # . # ~ ~ # # # . . . . # /
# . . . . # # # # # # . # # # # # # . . . . # /
# # # # # # ~ ~ ~ ~ ~ | ~ ~ ~ ~ ~ # # # # # # /
~ ~ ~ ~ ~ ~ ~ ~ ~ ~ ~ | ~ ~ ~ ~ ~ ~ ~ ~ ~ ~ ~ /
~ ~ ~ ~ ~ ~ ~ ~ ~ ~ ~ | ~ ~ ~ ~ ~ ~ ~ ~ ~ ~ ~ /
~ ~ ~ ~ ~ ~ ~ ~ ~ ~ ~ | ~ ~ ~ ~ ~ ~ ~ ~ ~ ~ ~ /
