. # # # # # # # # # # # # ~ # ~ ~ # # / 
. . . . . . . # . . . . . ~ . ~ . # # / 
# . . . . . . # . # # . . . . . . # # /
# . . . . . . # . . # . . ~ ` ~ . # # /
# . . . . . . # # . # . . ~ ~ ~ . # # /
# . . . . . . # # . # . . ~ ~ . . # # /
# # # # . # # # . . # . . ~ ~ . . # # / 
# . . . . # # # . # # . . # ~ ~ . . # /
# . # # # # . . . # . . . # ~ ~ # . # /
# . . . . . . # . # . . . # ~ ~ # . # /
# # # # . # # # . # # # # # ~ ~ # . # /
# . . . . . # # . # # . . . . ~ # . # /
# . . . . . # # . . . . . . . ~ # . # /
# . . . . . # # . # # . . . . ~ . . # /
# . . . . . # # . . # # # # # ~ ~ . # /
# # # # . . # # # . . . # # # ~ ~ . # /
# . . # . . . . # . # . # . . ~ ~ . # /
# . . . . . # . . . # . . . . ~ ~ . # /
# # # # # # # # # # # # # # # # # # # /